48
8
22 00 00 00 00 00 00 00 00 00 00 00 00 00 00 00 00 00 00 00 00 00 00 00 00 00 00 00 00 00 00 00 00 00 00 00 00 00 00 00 00 00 00 00 00 00 00 22
22 00 00 00 00 00 00 00 00 00 00 00 00 00 00 00 00 00 00 00 00 00 00 00 00 00 00 00 00 00 00 00 00 00 00 00 00 00 00 00 00 00 00 00 00 00 00 22
22 00 00 00 00 00 00 00 00 00 00 00 00 00 00 00 00 00 00 00 00 00 00 00 00 00 00 00 00 00 00 00 00 00 00 00 00 00 00 00 00 00 00 00 00 00 00 22
22 00 00 00 00 00 00 00 21 21 00 00 00 00 00 00 00 00 00 00 00 00 00 00 00 00 00 00 21 21 00 00 00 00 00 00 00 00 00 00 00 00 00 00 00 00 00 22
22 00 00 00 00 00 00 21 22 22 21 00 00 00 00 00 00 00 00 00 00 00 00 00 00 00 00 21 22 22 21 00 00 00 00 00 00 00 00 00 00 00 00 00 00 05 00 22
22 00 00 00 00 00 21 22 22 22 22 21 00 00 00 00 00 00 00 00 00 00 00 00 00 00 21 22 22 22 22 21 00 00 00 00 00 00 00 00 00 00 00 00 00 21 00 22
22 00 00 00 00 21 22 22 22 22 22 22 21 00 00 00 00 00 00 00 00 00 00 00 00 21 22 22 22 22 22 22 21 00 00 00 00 00 00 00 00 00 00 00 21 22 21 22
22 21 21 21 21 22 22 22 22 22 22 22 22 21 21 21 21 21 21 21 21 21 21 21 21 22 22 22 22 22 22 22 22 21 21 21 21 21 21 21 21 21 21 21 22 22 22 22

