30
8
22 00 00 00 00 00 00 00 00 00 00 00 00 00 00 00 00 00 00 00 00 00 00 00 00 00 00 00 00 22
22 00 00 00 00 00 00 00 00 00 00 00 00 00 00 00 00 00 00 00 00 00 00 00 00 00 00 00 00 22 
22 00 00 00 00 00 00 00 00 00 00 00 00 00 00 00 00 00 00 00 00 00 00 00 00 00 00 00 00 22
22 00 00 00 00 00 00 00 00 00 00 00 00 00 00 00 00 00 00 00 00 00 00 00 00 00 00 05 00 22 
22 00 00 00 00 00 00 00 00 00 07 04 00 00 00 00 00 00 00 00 23 24 25 00 00 00 21 21 21 22
22 00 00 06 04 00 00 00 00 00 01 02 00 00 00 00 21 21 00 00 00 00 00 00 00 00 22 22 22 22 
22 00 00 01 02 00 00 00 00 00 21 21 21 21 21 21 22 22 00 00 00 00 00 00 00 00 22 22 22 22
22 21 21 21 21 21 21 21 21 21 22 22 22 22 22 22 22 22 21 21 21 21 21 21 21 21 22 22 22 22 


